WWWWWWWWWWWW
W....W.....W
WW..W.WWWWWW
W..W.......W
W........W.W
WWWWW.WWWW.W
W..........W
WWWWWWWWWWWW