WWWWWWWWWWWW
W..........W
WWWWWWWWWW.W
W........W.W
W........W.W
W........W.W
W........W.W
WWWWWWWWWWWW