WWWWWWWWWWWW
W..........W
WW.........W
W..WWWWWW..W
W..........W
W..........W
W..........W
WWWWWWWWWWWW