WWWWWWWWWWWW
W..........W
WW.........W
WWW........W
WWWW.......W
W..........W
W..........W
WWWWWWWWWWWW