WWWWWWWWWWWW
W..........W
WW.........W
WWW........W
WWWW......WW
W........WWW
W.......WWWW
WWWWWWWWWWWW